+-+-+-+-+-+-+-+-+-+-+-+-+-+-+-+-+-+-+-+-+-+-+-+-+-+-+-+-+-+-+-+-+-+-+-+-+-+-+-+-+-+-+-+-+-+-+-+-+-+-+-+-+
  |   | |   |     |   | |     |     |   |     |         |           |     |         |   | |   |     |   |
+ + + + + + + +-+ +-+ + + + + + +-+-+ + + +-+ + +-+-+-+ + +-+-+-+ +-+ +-+ + +-+-+-+ + + + + + +-+ + + + +
| | |     |   |   |   |   | | |     | | | |   | |   |   |       |     |   |       |   |   | |   | |   | |
+ + +-+-+-+-+-+ +-+ +-+-+-+-+ + +-+ + + + + +-+ + + + +-+-+-+ + +-+-+-+ +-+-+-+-+ +-+-+ + + +-+ + +-+-+ +
|   |     |   | |   |   |     | |     | | |   | | | | |   |   | |     |   |     |   |   |   | | | |     |
+-+-+ +-+ +-+ + + +-+-+ + +-+-+ +-+-+-+ +-+ + + + + + + + +-+-+-+ +-+ +-+ + +-+ +-+ + +-+-+-+ + + +-+-+-+
|     | |       | |     |       |       |   | | | | | | |   | |   |       |   | | | |   |   | | |   |   |
+ +-+-+ +-+-+ +-+ + +-+-+-+-+-+-+ +-+-+-+ +-+ + + + + + +-+ + + +-+ +-+-+-+-+ + + + +-+ + + + + +-+ + + +
|   | |     |   | |     |         |   |   | | |   | | | |   | |   | |   |   | | | | | | | |   | | |   | |
+-+ + + +-+ +-+ + + + +-+ +-+-+-+ +-+ + +-+ + +-+-+-+ + +-+-+ +-+ + + + + + +-+ + + + + + +-+-+ + + +-+ +
|   | |   |   | | | |   | |   |       | |   |         |   |   |   | | |   | |   |     | |         |   | |
+ +-+ +-+ + + + + + +-+ +-+ + + + + +-+ + + +-+ +-+-+-+ + +-+ + +-+ + +-+-+ + +-+ +-+-+ +-+-+-+-+-+-+ +-+
|   |     | | | | | |   |   |   | | |   | | |         | | |     | | |     |   |   |   |       |     |   |
+-+ +-+-+-+-+ +-+ +-+ +-+ +-+-+-+ + + + + + +-+-+ +-+ + + + +-+-+ + + +-+ +-+-+ +-+ + +-+ +-+-+ +-+ + + +
|   |   |     |   |     | |     | |   | | |     |   | | |       |   |   |     |     |   |     |   | | | |
+ +-+-+ + +-+-+ +-+ + + + + +-+ + +-+-+ + +-+-+-+-+-+ + +-+ +-+ +-+-+-+ +-+-+ +-+-+-+-+ +-+-+ +-+ + + +-+
|   |     |   | |   | |   |   |     |   |           | |   | |   | |   | |   | |     | |   | |     |     |
+-+ + + +-+ + + + +-+ +-+-+-+ +-+ + +-+-+-+-+-+-+-+ + +-+-+ + +-+ + + + + +-+ + +-+ + +-+ + +-+-+-+ +-+ +
|   | |   | |   | | | | |   |   | |   |       | |   | |     | |   | |   |     |   | |     |   |     |   |
+ + + +-+ + +-+-+ + + + + +-+-+ + +-+ + +-+ + + + +-+ + +-+-+ + +-+ +-+-+-+ +-+-+ + +-+ +-+-+ + +-+-+ + +
| | | | |       | |   |   |     | |   |   | |   |   |   |     | |   |     | |   | |     |   | | |   | | |
+ +-+ + +-+ +-+-+ +-+-+ + + +-+-+-+ +-+-+-+ +-+-+-+ +-+-+ +-+ + +-+ + +-+ + + + + +-+-+ + + + + + + + + +
| |   |   |       |     | | |           |   |     | |     |   |   | | | | |   | | |     | | |   | | | | |
+ + +-+-+ +-+-+-+-+ +-+-+ + +-+-+-+-+-+ + +-+ +-+-+ + +-+-+ +-+-+ + + + + +-+-+-+ +-+-+ + +-+ +-+ + + +-+
|   |   | |       | |     | |   |     | | |     |   |     | |     | | |           |   | |         | |   |
+ +-+-+ + + +-+-+ + + +-+-+-+ + + +-+-+ + + + + + +-+-+-+ + + +-+ + + +-+-+-+-+-+-+ + +-+-+-+-+-+-+ +-+ +
|     | | |     | | |   |     | | |     |   | | |         | | |     |   |   |   |   |     |   |     | | |
+-+-+ + + +-+ +-+ + + + + +-+-+ + +-+ +-+-+-+-+ +-+-+-+-+-+-+ +-+-+-+-+ +-+ + + + +-+-+-+ +-+ +-+-+-+ + +
| |     |       | | | | | |     |   |   | |   |         |   | |       |   | | | | |   | |   | |         |
+ + +-+-+-+-+ + + + + + + + + +-+-+ +-+ + + + +-+ +-+-+ + + + + +-+-+ +-+ + + +-+ + + + +-+ + + +-+-+-+-+
| |         | | |   | |   | | |   | |     | |   |     | | |   | | |   | | |       | |   | |     |       |
+ +-+-+-+ +-+ + +-+-+ +-+-+-+ + + + + +-+-+ +-+ +-+-+ +-+ +-+-+ + + +-+ + +-+ +-+-+ + +-+ +-+-+ + +-+-+ +
|         |   |     | |       | | | | |   |   | |     |   |     | | |   | |   |     |     |   | |   |   |
+-+-+ +-+-+ +-+-+ +-+ + +-+-+-+-+ + + + + +-+ + + +-+ + +-+ +-+ + + + +-+ + +-+ +-+-+-+-+-+ + + +-+-+ +-+
| |       | |   |   | | |         | |   |     |   |   |   |   | | | |   | |     |       |   | |     | | |
+ + + +-+-+ + +-+-+ + + +-+-+-+ +-+ +-+-+-+-+-+-+-+ +-+ + +-+ +-+ + +-+ + +-+-+-+-+-+-+ +-+-+ +-+-+ + + +
|   |       | |   | | |       | |             |   |     | | | |   |   | |   | |   | |         |   |   | |
+-+-+-+ +-+-+ + +-+ + +-+-+-+ + + + +-+-+-+-+-+ + + +-+-+ + + + +-+-+ + +-+ + + + + + +-+-+-+-+ + +-+-+ +
|     |       |     | |         | | |           |   | |     | | |     |         |   | | |   | | | |   | |
+ +-+ +-+-+-+ +-+-+-+ + +-+-+ +-+ + + +-+-+ +-+-+-+-+ + +-+-+ + + +-+-+-+-+ +-+-+ + + + + + + + + + + + +
|   |       | |   |   | |   | |   | |   |   |     |   | |   | |     |       |   | |     | | | | | | | | |
+ +-+-+-+-+ + + +-+ +-+-+ + + + +-+ +-+ + +-+ +-+ + + + + + + +-+-+ + +-+ +-+ + + +-+ +-+ + + + + + + + +
|   |     | | |     |   | |   |   |   | |   |   | | |     | | |     | |   | | | |   |   | | |   |   |   |
+-+ +-+-+ + +-+-+ + +-+ + +-+-+-+-+-+ + +-+ + + +-+ +-+-+-+ + + +-+-+ +-+-+ + + +-+-+-+ +-+ + + +-+-+-+ +
|   |   | |     | | |   |     |     |   |   | |   | | |     | | |   | |     | |   |     |   | | |       |
+-+ + + + +-+-+ + +-+ + + +-+ + +-+ +-+-+ +-+ +-+ + + + +-+-+ + + + + + +-+ +-+-+ + +-+-+ +-+ +-+ +-+-+-+
|   | |   |   | |     | |   | |   | | |   |   | |     |   |   |   |   |   |   | | |     | |   |     |   |
+ +-+ +-+-+ + + + +-+-+-+-+ + +-+ + + + +-+ +-+ +-+-+-+-+ + +-+-+-+-+-+-+ +-+ + + +-+-+ + + +-+ + + +-+ +
|     |     | | | |     |   |     | | | |   |   |         | |   |         | |       |     | | | | |     |
+-+-+ + +-+-+-+ +-+ +-+ + +-+-+-+-+ + + + +-+-+ + +-+-+-+ + + + + +-+-+-+-+ +-+-+ +-+ + +-+ + + + +-+-+-+
|     |               |   |         |   |       |       |   | |             |         |     |   |        
+-+-+-+-+-+-+-+-+-+-+-+-+-+-+-+-+-+-+-+-+-+-+-+-+-+-+-+-+-+-+-+-+-+-+-+-+-+-+-+-+-+-+-+-+-+-+-+-+-+-+-+-+